a	/ei/	art.一(个);每一(个);(同类事物中)任一个
abandon	/ə'bændən/	vt.离弃,丢弃;遗弃,抛弃;放弃
abdomen	/æb'dəumen/	n.腹,下腹(胸部到腿部的部分)
abatement	/ə'beitmənt/	n.减(免)税,打折扣,冲销
abide	/ə'baid/	vi.(abode,abided)(by)遵守;坚持;vt.忍受,容忍
ability	/ə'biliti/	n.能力;本领;才能,才干;专门技能,天资
able	/'eibl/	a.有(能力、时间、知识等)做某事,有本事的
abnormal	/æb'nɔ:məl/	a.反常的,不正常的,不规则的
aboard	/ə'bɔ:d/	ad.&prep.在船(飞机、车)上;ad.上船(飞机、车)
abolish	/ə'bɔliʃ/	vt.废除(法律、习惯等);取消
abound	/ə'baund/	vi.大量存在;(~in,~with)充满,富于
about	/ə'baut/	ad.在周围;大约prep.关于;在周围a.准备
above	/ə'bʌv/	a.上述的ad.在上面,在前文prep.在..之上,高于
abroad	/ə'brɔ:d/	ad.到国外,在国外;在传播,在流传
abrupt	/ə'brʌpt/	a.突然的,出其不意的;(行为等)粗鲁无礼的
absence	/'æbsəns/	n.缺乏,不存在;缺席,不在场;缺席的时间
absent	/'æbsənt,æb'sent/	a.缺席的;缺乏的,不存在的;心不在焉的
absolute	/'æbsəlju:t/	a.绝对的,完全的;确实的,肯定的
absorb	/əb'sɔ:b,-'zɔ:b/	vt.吸收(水、光、蒸汽等）;使全神贯注;吞并/兼并
abstract	/'æbstrækt/	a.抽象的n.摘要,文摘,梗概vt.提取;摘录要点
absurd	/əb'sə:d/	a.荒谬的,荒诞的,荒唐可笑的;不合理的
abundance	/ə'bʌndəns/	n.丰富,充裕,大量
abundant	/ə'bʌndənt/	a.大量(充足)的;(in)丰富(富裕)的
abuse	/ə'bju:z,ə'bju:s/	vt.滥用;虐待,辱骂;诋毁n.滥用;恶习;弊端
academic	/,ækə'demik/	a.学院的,学术性的;大学的;理论的
academy	/ə'kædəmi/	n.(高等)专科院校;学术社团,协会,研究院
accelerate	/ək'seləreit/	v.使加速,使增速,促进vi.加快,增加
accent	/'æksənt,æk'sent/	n.口音,腔调;重音(符号)vt.重读
accept	/ək'sept/	vt.接受,领受;认可,同意vi.同意,认可
acceptable	/ək'septəbl/	adj.可接受的,合意的
acceptance	/ək'septəns/	n.接受,接收,验收,接纳;承认,认可
access	/'ækses/	n.进入;接入;到达;享用权;入口vi.存取
accessory	/ək'sesəri/	n.附件,附属品;(为全套衣服增加美感的)服饰
accident	/'æksidənt/	n.意外遭遇,事故;意外(因素)
accidental	/,æksi'dentəl/	a.偶然的;意外的;无意中的
acclaim	/ə'kleim/	v.向…欢呼,公认n.欢呼,喝彩,称赞
accommodate	/ə'kɔmədeit/	vt.向…提供住处;对...予以照顾性考虑
accommodation	/ə,kɔmə'deiʃən/	n.(accommodations)住宿,留宿;膳宿供应
accompany	/ə'kʌmpəni/	v.陪伴,陪同;伴随,和...一起发生,伴奏
accomplish	/ə'kʌmpliʃ,ə'kɔm-/	v.实现(计划等);达到(目的);完成(任务)
accord	/ə'kɔ:d/	vt.给予(欢迎、称颂等)vi.&n.符合,一致
accordance	/ə'kɔ:dəns/	n.一致,和谐,符合
accordingto	/ə'kɔ:diŋtu/	prep.据/照…(所说、所写);按…,视…
accordingly	/ə'kɔ:diŋli/	ad.相应地,照着办,按照;于是,因此
account	/ə'kaunt/	a.叙述,说明;账目,账户vi.说明,解释
accountant	/ə'kauntənt/	n.会计人员,会计师
accumulate	/ə'kju:mjuleit/	vt.堆积,积累,积聚vi.累积,聚积
accuracy	/'ækjurəsi/	n.准确（性）;精确;准确度
accurate	/'ækjurət/	a.正确无误的;准确的,精确的
accuse	/ə'kju:z/	vt.控告,指责vi.指控,指责
accustomed	/ə'kʌstəmd/	a.惯常的;习惯的,适应的(一般作表语)
ache	/eik/	vi.痛;哀怜n.(指连续)疼痛、酸痛
achieve	/ə'tʃi:v/	vt.实现,完成;达到,得到vi.达到预期目的
acid	/'æsid/	n.酸,酸性物质a.酸的,酸味的;尖刻的
acknowledge	/ək'nɔlidʒ/	vt.承认;接受;告知(信件等的)收到;答谢
acquaint	/ə'kweint/	vt.(with)使认识,使了解,使熟悉
acquaintance	/ə'kweintəns/	n.认识,相识,了解;相识的人,熟人
acquire	/ə'kwaiə/	v.获得;学到(知识等);养成(习惯)
acquisition	/,ækwi'ziʃən/	n.取得,学到,养成(习惯);获得的东西
acre	/'eikə/	n.英亩;田地;地产
acrobat	/'ækrəbæt/	n.特技演员,杂技演员
across	/ə'krɔs,ə'krɔ:s/	prep.横过,越过;在的对面ad.横过,穿过
act	/ækt/	v.表演;举动;起作用n.行为,法令;一幕
action	/'ækʃən/	n.行动,动作;作用;运转;行为;战斗
activate	/'æktiveit/	vt.启动,激活;驱动,驱使;使开始起作用
active	/'æktiv/	adj.活跃的,敏捷的,积极的;在活动中的
activity	/æk'tivəti/	n.活动;活力;能动性;
actor	/'æktə/	n.男演员;演员,行动者
actress	/'æktris/	n.女演员
actual	/'æktʃuəl/	a.实际的;现实的,真实的,目前的
acute	/ə'kju:t/	a.剧烈的;敏锐的;成锐角的;尖的,高音的
adapt	/ə'dæpt/	vt.使适应,使适合;改编;改写vi.适应
add	/æd/	vt.加;增加(进);进一步说/写vi.(to)增添
addict	/ə'dikt/	v.使沉溺;使上瘾n.沉溺于不良嗜好的人
addition	/ə'diʃən/	n.加,加法;附加部分,增加(物)
additional	/ə'diʃənəl/	a.额外的,附加的,另外的
address	/ə'dres/	n.住址;致词v.向...致词;在信封上写姓名
adequate	/'ædikwit/	adj.充足的,足够的;适当的,胜任的
adhere	/əd'hiə/	vi.(to)粘着;坚持,遵守;依附,追随
adjacent	/ə'dʒeisənt/	a.(to)(时间上)紧接着的;邻近的,毗邻的
adjective	/'ædʒiktiv/	n.形容词a.形容词的,用作形容词的
adjoin	/ə'dʒɔin/	v.临近,靠近;贴近,毗连
adjust	/ə'dʒʌst/	vt.调节;整顿,调整vi.适应(to);使调节
administer	/əd'ministə/	v.施行,实施;掌管,料理...的事务;给予
administration	/əd,mini'streiʃən/	n.经营,管理;行政,行政机关,管理部门
admire	/əd'maiə/	vt.钦佩,赞赏,羡慕;称赞,夸奖
admission	/əd'miʃən/	n.允许进入;承认;入场费,入会费,入场券
admit	/əd'mit/	vt.承认,供认;准许…进入,准许...加入
adolescent	/,ædəu'lesənt/	n.青少年a.青春期的,青少年的
adopt	/ə'dɔpt/	vt.采用,采取(态度等);选定;收养
adore	/ə'dɔ:/	vt.崇拜,敬慕,爱慕;非常喜欢
adult	/'ædʌlt,ə'dʌlt/	n.成年人a.成年的,充分长成的,成熟的
advance	/əd'vɑ:ns,əd'væns/	n.前进,预付vi.前进,进展vt.促进,推进
advanced	/əd'vɑ:nst,-'vænst/	a.超前的,先进的;高级的;开明的;前进的
advantage	/əd'vɑ:ntidʒ/	n.优点,长处,有利条件;利益,好处
advent	/'ædvənt/	n.(重要事件等的)到来,来临
adventure	/əd'ventʃə,æd-/	n.冒险,冒险活动,奇遇vt.大胆进行
adverb	/'ædvə:b/	n.副词a.副词的
adverse	/'ædvə:s,æd'və:s/	a.逆的,相反的;敌对的;不利的;有害的
advertise	/'ædvətaiz/	vt.公告,公布;为...做广告vi.登广告